00000000000000000000000000000000000000000000000000000000000000000000000000000000000000000000000000000000000000000000000000000000000000000000000000000
00000000000000000000000000000000000000000000000000000000000000000000000000000000000000000000000000000000000000000000000000000000000000000000000000000
00000000000000000000000000000000000000000000000000000000000000000000000000000000000000000000000000000000000000000000000000000000000000000000000000000
00000000000000000000000000000000000000000000000000000000000000000000000000000000000000000000000000000000000000000000000000000000000000000000000000000
00000000000000000000000000000000000000000000000000000000000000000000000000000000000000000000000000000000000000000000000000000000000000000000000000000
00000000000000000000000000000000000000000000000000000000000000000000000000000000000000000000000000000000000000000000000000000000000000000000000000000
00000000000000000000000000000000000000000000000000000000000000000000000000000000000000000000000000000000000000000000000000000000000000000000000000000
00000000000000000000000000000000000000000000000000000000000000000000000000000000000000000000000000000000000000000000000000000000000000000000000000000
00000000000000000000000000000000000000000000000000000000000000000000000000000000000000000000000000000000000000000000000000000000000000000000000000000
00000000000000000000000000000000000000000000000000000000000000000000000000000000000000000000000000000000000000000000000000000000000000000000000000000
00000000000000000000000000000000000000000000000000000000000000000000000000000000000000000000000000000000000000000000000000000000000000000000000000000
00000000000000000000000000000000000000000000000000000000000000000000000000000000000000000000000000000000000000000000000000000000000000000000000000000
00000000000000000000000000000000000000000000000000000000000000000000000000000000000000000000000000000000000000000000000000000000000000000000000000000
00000000000000000000000000000000000000000000000000000000000000000000000000000000000000000000000000000000000000000000000000000000000000000000000000000
00000000000000000000000000000000000000000000000000000000000000000000000000000000000000000000000000000000000000000000000000000000000000000000000000000
00000000000000000000000000000000000000000000000000000000000000000000000000000000000000000000000000000000000000000000000000000000000000000000000000000
0000000000x000000000000000000000000000000000000000000000000000000000000000000000000000000000000000000000000000000000000000000000000000000000000000000
00000000000000000000000000000000000000000000000000000000000000000000000000000000000000000000000000000000000000000000000000000000000000000000000000000
00000000000000000000000000000~__________~__0000000000000000000000000000000000000000000000000000000000000000000000000000000000000000000000000000000000
00000000000000000000000000=!!!!$$$$$$$$!$$*00_~___000000000000000000000000000000000000000000000000000000000000000000000000000000000000000000000000000
00000000000000000000000000|###,##12##,####**!$$$!!!$e000000000000000000000000000000000000000000000000000000000000000000000000000000000000000000000000
00000000000000000000000000[##.##.34#,##.####.#%%}00000000~_000000000000000000000000000000000000000000000000000000000000000000000000000000000000000000
00000000000000000000000000|--------------------}0000000e$$e0000__~__0?0000000000000000000000000000000000000000000000000000000000000000000000000000000
00000000000000000000000000|/0000000000000000000000000000000000!$$$$$!!!&00000000000000000000000000000000000000000000000000000000000000000000000000000
00000000000000000000000000|/000000000000000000000000000000000=%###,####]00000000000000000000000000000000000000000000000000000000000000000000000000000
00000000000000000000000000|/00000000000000000000000000000000=%#######.#/00000000000000000000000000000000000000000000000000000000000000000000000000000
00000000000000000000000000|/000000000000000000______000000**%####,##.##/00000000000000000000000000000000000000000000000000000000000000000000000000000
00000000000000000000000000[#$$$$&+=$$$!$!!!!!!!$$$$*****!!%%%##,######-/00000000000000000000000000000000000000000000000000000000000000000000000000000
00000000000000000000000000|###,#]+[##,####.####,###,###.###.####.##--}0000000000000000000000000000000000000000000000000000000000000000000000000000000
00000000000000000000000000{-----}+{-------------------------------}0000000000000000000000000000000000000000000000000000000000000000000000000000000000
000000000000000000000000000000000+0000000000000000000000000000000000000000000000000000000000000000000000000000000000000000000000000000000000000000000
000000000000000000000000000000000+00000000000000000000000000000000__000000000000000000000000000000000000000000000000000000000000000000000000000000000
000000000000000000000000000000000+00000000000000000000000000000*!$$&000000000000000000000000000000000000000000000000000000000000000000000000000000000
000000000000000000000000000000000+00000000000000000000000000000*###%&00000000000000000000000000000000000000000000000000000000000000000000000000000000
000000000000000000000000000000000+00000000000000000000000000000*##.#***____000000000000000000000000000000000000000000000t0000000000000000000000000000
000000000000000000000000000000000+0000000000000000000___~______*###.#%%$$$$$&___~______0000__~______________?0_________tt______________~_____________
000000000000000000000000000000000+0000000000000012***$$$$!$!$$$*#,#,##.#####%$$$$!!!$$$&+=$$$!$$!!$$$$$$$$$$!!!!!!!!!!!!$$$$$$$$!$!$!$$$$$$$$$$!$$!$!
000000000000000000000000000000000+________~____*34**ab#,###.############.######,####,##/+{---------------#######.######,#####,########,######.####,##
000________0000000000000000___=$$$!$$$$!$$$$$$$$***#cd###.##################.#####,####/+0000000000000000|##,####.####,########,####.##.#####,#######
#$$$$$$!$$$&___?_________**$$$%#######################*########.#####,######,###.######/+0000000000000000|########,###,####,#######.#######,###.#####
###########%$$!$$$$$!$$$$$$%#######,########,###.#####,#################,#####,######.#]+0000000000000000|##.###############.######,###,#########,###
###.##############################################################,#######,############]+0000000000000000[#.####.#############,##################,###
####,#######.###########.#############,######.#####,#####.##############,######.#######/+__?_____________|###,##.################,########,##########
########.###########,###########,#########.########################################,###%!$$$$$$$&&&&!!!&&!####,######################################
################,################.############,########################################.#####,##,#######.############################################
######,####.#############.############,###################################################*12***#########.###########################################
################,################.############,######################.#####,##,#######.###*34*****.#####,############################################
######,####.#############.############,###################################################********##############,####################################
################,################.############,################################.#####,##,#######.####################################################
######,####.#############.############,##############################################################################################################
